***N*****
* * *   *
* * * ***
*   * * X
*** * * *
* *   * *
*   *   *
* **** **
*********
